WWWW0WWWWW
W        W
W  S     W
WWWWW    W
W   W   sW
W   W  WWW
W  h     W
W      b W
W        W
WWWWWWWWWW
