#
# 0 E room1.txt 1
# 1 D room3.txt 0 key1
#
WWWWWWWWWW
W        W
W        W
W        W
W   WWWW W
W      W W
W      W W
W  WWWWW W
0  W     W
WWWWWWWW1W